#########
#S......#
#########
#.....#.#
#...#.#.#
###.#.#.#
#.....#.#
#.###..E#